1111111111111111111111111111
1000000000000110000000000001
1011110111110110111110111101
1012210122210110122210122101
1011110111110110111110111101
1000000000000000000000000001
1011110110111111110110111101
1011110110111111110110111101
1000000110000110000110000001
1111110111110110111110111111
2222210111110110111110122222
2222210110000000000110122222
2222210110111111110110122222
1111110110122222210110111111
0000000000122222210000000000
1111110110122222210110111111
2222210110111111110110122222
2222210110000000000110122222
2222210110111111110110122222
1111110110111111110110111111
1000000000000110000000000001
1011110111110110111110111101
1011110111110110111110111101
1000110000000PP0000000110001
1110110110111111110110110111
1110110110111111110110110111
1000000110000110000110000001
1011111111110110111111111101
1011111111110110111111111101
1000000000000000000000000001
1111111111111111111111111111